111111111111111
 101000C01C0001
10010100000C001
100C01111100011
1P0011E0C000001
101001111100001
1C10000C0000001
111111111111111