111111111111111
10M1000C01CM001
10010100M00C001
100C01111100111
1P0011E0CM00001
1010011111    1
1C100M0C00    1
111111111111111