111111111111111
1001000C01CM001
10010100M00C001
100C11111100111
1P0111E0C000001
110001111100101
1C10000C00001C1
111111111111111