11111111111111111
100100010C00011C1
10010100000C01C01
100C0111111001101
1P0011E0000000001
11111111111111111