111111111111111
1001000C01C0001
10010100000C001
100C01111100111
1P0011E0C000001
101001111100101
1C10000C00001C1
111 11111111111